1
1
11111111111111111111111111111111111111111100000000111111111111111111111111111111111111111111
11000000000000000000000000000000000000000000000000000000000000000000000000000000000000000011
11000000000000000000000000000000000000000000000000000000000000000000000000000000000000000011
11000000000000000000000000000000000000000000000000000000000000000000000000000000000000000011
11000000000000000000000000000000000000000000000000000000000000001111111100000000000000000011
11000000000000000000000000000000000000000000000000000000000000001111111100000000000000000011
11000000000000111111100000000000000000000000000000000000000000001111111100000000000000000011
11000000000000111111100000000000000000000000000000000000000000001111111100000000000000000011
11000000000000111111100000000000000000000000000000000000000000000000000000000000000000000011
11000000000000111111100000000000000000000000000000000000000000000000000000000000000000000011
11000000000000000000000000000000000000000000000000000000000000000000000000000000000000000011
11000000000000000000000000000000000000000000000000000000000000000000000000000000000000000011
11000000000000000000000000000000000000000000000000000000000000000000000000000000000000000011
11000000000000000000000000000000000000000000000000000000000000001111111100000000000000000011
11000000000000000000000000000000000000000000000000000000000000001111111100000000000000000011
11000000000000000000000000000000000000000000000000000000000000001111111100000000000000000011
00000000000000000000000000000000000000000000000000000000000000001111111100000000000000000000
00000000000000000000000000000000000000000000000000000000000000000000000000000000000000000000
00000000000000000000000000000000000000000111111100000000000000000000000000000000000000000000
00000000000000000000000000000000000000000111111100000000000000000000000000000000000000000000
11000000000000000000000000000000000000000111111100000000000000000000000000000000000000000011
11000000000000000000000000000000000000000111111100000000000000000000000000000000000000000011
11000000000000000000000000000000000000000000000000000000000000000000000000000000000000000011
11000000000000000000000000000000000000000000000000000000000000000000000000000000000000000011
11000000000000000000000000000000000000000000000000000000000000000000000000000000000000000011
11000000000000000000000000000000000000000000000000000000000000000000000000000000000000000011
11000000000000000000000000000000000000000000000000000000000000000000000000000000000000000011
11000000000000000000000000000000000000000000000000000000000000000000000000000000000000000011
11000000000011111111000000000000000000000000000000000000000011111111000000000000000000000011
11000000000011111111000000000000000000000000000000000000000011111111000000000000000000000011
11000000000011111111000000000000000000000000000000000000000011111111000000000000000000000011
11000000000011111111000000000000000000000000000000000000000011111111000000000000001111111111
11000000000000000000000000000000000000000000000000000000000000000000000000000000001111111111
11000000000000000000000000000000000000000000000000000000000000000000000000000000001111111111
11000000000000000000000000000000000000000000000000000000000000000000000000000000001111111111
11111111111111111111111111111111111111111100000000111111111111111111111111111111111111111111